11111
1P1C1
11101
1C0E1
11111
