1111111111111111111111
1P000C0000C0000C000E01
1111111111111111111111
