1111111
1P000C1
1110101
1C00101
1011111
1000C01
11111E1
1111111
