1111111111
1P000000C1
1011111101
1C00001011
1010110101
1000100101
1011101111
1C000000E1
1011111111
1111111111
