111111111111111111111111111111111111111111111111111111111111111111111111111111111111111111111111111111111111111111
1P00C00C00C00C00C00C00C00C00C00C00C00C00C00C00C00C00C00C00C00C00C00C00C00C00C00C00C00C00C00C00C00C00C00C00C00E0001
111111111111111111111111111111111111111111111111111111111111111111111111111111111111111111111111111111111111111111
